11111111111111111111
10000000000000000001
10111111111111111101
101C0000000000000001
101000000000C0000001
10100000E00000000001
10100000000000000001
10100000000000000001
101000000000C0000001
1010C000000000000001
10100000000000000001
101000000000C0000001
10100000000000000001
1010C000000000000001
10100000000000000001
10111111111111111111
10000C00000000C00001
11111111111111111101
10P0C000000000000001
11111111111111111111