11111111111111111111111111
10000000000000000000000001
10111111111111111111111111
101C0000000000000000000001
101000000000C0000000V00001
10100000E00000000000000001
10100000000000000000000001
10100000000000000000V00001
101000000000C0000000000001
1010C000000000000000000001
10100000000000000000000001
1010V0000000C0000000000001
10100000000000000000000001
1010C00000000000000000P001
11111111111111111111111111