1111111111
1100000C01
1C000000A1
1P00E00101
1111111111