1111111111111111111111111111111111111111
1000000000000000000000000000000000000001
101C000000000000000000000000000000000001
101000000000C0000000V0000000000000000001
10100000E0000000000000000000000000000001
1010A00000000000000000000000000000000001
10100000000000000000V0000000000000P00001
101000000000C000000000000000000000000001
1010C00000000000000000000000000000000001
1010000000000000000000000000000000000001
10100000000C0000000000000000000000000001
1010000000000000000000000000000000000001
1010C00000000000000000000000000000000001
1011111111111111111111111111111111111111
101C000000000000000000000000000000000001
101000000000C000000000000000000000000001
1010000000000000000000000000000000000001
1010000000000000000000000000000000000001
10000000000000000000V0000000000000000001
1111111111111111111111111111111111111111