1111111111111111111111111111111111
1EV000000000000C00000C000000000001
1V10010100100000101001000000010101
1010010010101010P01001000000010101
100000000C00C0000000000000000000C1
1111111111111111111111111111111111
