111111111111111111111
1P0100000000000000C01
100000000000000000001
100000000000000000001
100000000000000000001
100000000000000000001
100000000000000011111
100000000000000011111
1000000000000000CCEC1
111111111111111111111