1111111111111111111111111111111111
1C1E00000000000C00000C000000000001
1010010100100000101001000000010101
1110010010101010P01001000000010101
100000000C00C0000000000000000001C1
1111111111111111111111111111111111