111111111111111111111
1P0000000000000000EC1
111111111111111111111