1111111111
10CVVVVEV1
1011111111
1P10AV0001
1111111111